wwwwwwwwwwwwwwwwccwwwwwwwwwwwwww
w               cc             w
w                              w
w                              w
w                              w
w                              w
w                              w
w                              w
w                              w
ws                             f
wwwwwwwww  wwwwwwwwwwww  wwwwwww
w        w              w      w
w         w            w       w
wwwwwwwwwwwwwwwwwwwwwwwwwwwwwwww
wwwwwwwwwwwwwwwwwwwwwwwwwwwwwwww
wwwwwwwwwwwwwwwwwwwwwwwwwwwwwwww
wwwwwwwwwwwwwwwwwwwwwwwwwwwwwwww
wwwwwwwwwwwwwwwwwwwwwwwwwwwwwwww
