wwwwwwwwwccwwwwwwwwwwwwwwwwwwwww
w        cc                    w
w                              w
w                              w
w                              w
w                              w
w                              w
w                              w
w                              w
w                              f
      wwwwwwwwwwwwwwwwwww  wwwww
     w                    w    w
s   w                    w     w
ww w                    w      w
w                              w
wwwwwwwwwwwwwwwwwwwwwwwwwwwwwwww
wwwwwwwwwwwwwwwwwwwwwwwwwwwwwwww
wwwwwwwwwwwwwwwwwwwwwwwwwwwwwwww
