wwwwwwwwwccwwwwwwwwwwwwwwwwwwwww
w        cc                    w
w                              w
w                              w
w                              w
w                              w
w                              w
w                              w
w                              w
w                              f
      wwwwwwwwwwwwwwwwwww  wwwww
w    w                    w    w
ws  w        w           w     w
ww w         ww         w      w
w            www               w
wwwwwwwwwwwwwwwwwwwwwwwwwwwwwwww
wwwwwwwwwwwwwwwwwwwwwwwwwwwwwwww
wwwwwwwwwwwwwwwwwwwwwwwwwwwwwwww
