wwwwwwwwwwwwwwwwwwwwwwwwwwwwwwww
w                              w
w                              w
w                              w
w                              w
w                              w
w                              w
w                              w
w                w             w
ws               ww            f
wwwwww  wwwwwwwwwwwwwww  wwwwwww
w     w                 w      w
w      w               w       w
wwwwwwwwwwwwwwwwwwwwwwwwwwwwwwww
wwwwwwwwwwwwwwwwwwwwwwwwwwwwwwww
wwwwwwwwwwwwwwwwwwwwwwwwwwwwwwww
wwwwwwwwwwwwwwwwwwwwwwwwwwwwwwww
wwwwwwwwwwwwwwwwwwwwwwwwwwwwwwww
